1 1 1 1 1 1 1 1 1 1 1 1 1 1 1 1 1 1 1 1 1 1 1 1 1 1
1 0 0 0 0 0 0 0 0 0 0 0 0 0 0 0 0 0 0 0 0 0 0 0 0 1
1 0 1 0 0 2 1 0 1 1 1 1 0 1 1 1 1 1 0 1 1 1 1 1 0 1
1 0 1 1 0 1 1 0 1 6 7 1 0 0 0 1 3 0 0 1 3 0 0 0 0 1
1 0 1 0 1 0 1 0 1 5 4 1 0 0 0 1 0 0 0 1 1 1 0 0 0 1
1 0 1 0 0 0 1 0 1 3 3 1 3 0 0 1 0 0 0 1 0 0 3 0 0 1
1 0 1 0 0 0 1 0 1 0 0 1 0 0 0 1 0 0 0 1 0 0 0 0 0 1
1 0 1 0 0 0 1 0 1 0 0 1 0 0 0 1 0 0 0 1 0 0 0 0 0 1
1 0 0 0 0 0 0 0 0 0 0 0 0 0 0 0 0 0 0 0 0 0 0 0 0 1
1 1 1 1 1 1 1 1 1 1 1 1 1 1 1 1 1 1 1 1 1 1 1 1 1 1
